#######
#.#e..#
#.#.#.#
#...#.#
#s#...#
#######
